%%%%%%%%%%%%%%%
%G oP   o.G   %
%%%%%%%%%%%%%%%